Anglicky=English
Procedury=Procedures
Vybavení hotelu=Hotel facilities
Lokalita hotelu=Location 
UPRAVIT TERMÍN A OSTATNÍ=Change date and terms
Snídaně=Breakfast
Polopenze=Half Board
Plná penze=Full Board
Stravování:=Meal Plan:
Počet osob:=Person
Dostupné pokoje v termínu:=Available rooms at the date
Nabídka pokojů=Rooms offer
Rezervovat=Book
Výhled z pokoje=rooom view
Vybavení hotelu=Hotel facilities
Nekuřácký pokoj=Non-smoking room
Pokojová služba=Room service
Domácí zvířata povolena=Pets allowed
Bezbariérový pokoj=Disabled room
Hesla nejsou schodná=Wrong password
Heslo musí mít minimálně 8 znaků=Password must be at least 8 characters
Toto nevypadá jako telefon=Wrong number
Tento email je již zaregistrovaný=This email is already registered
Toto nevypadá jako email=Wrong email
Příjmení je příliš krátké=surname is too short
Jméno je příliš krátké=name is too short
Vítejte zpět=Welcome back
Osobní údaje=Personal date
Přihlášení=Login
Více z tohoto města=More about the city
Paní=Ms
Pan=Mr
Pokračovat v rezervaci=Continue to booking
Můj účet=My Account
Přihlášení   odběru novinek=Subscribing to news
Kontakt=Contact
Galerie=Galery
Karlovy Vary=Karlovy Vary
Léčebné centrum=Medical centre
Obchodní podmínky=Terms and conditions
Ubytování=Accommodation 
Vybavení pokoje=Room facilities
Při aktuálním výběru osob nelze tento pokoj rezerovat=Not bookable with current selection of people 
Pokoje=Rooms
Tento pokoj není v tomto datu k dispozici=NOT AVAILABLE
Dotaz byl odeslán=The query was sent 
Hesla nejsou shodná=Passwords do not match 
Procedur během pobytu=Procedures during the stay
Sankce=Penalty
Storno 29 a více=Cancel before 29 and more days
Storno 22-28 dnů= Cancel before 22-28 days
Storno 15-21 dnů=Cancel before 15-21 days
Storno 8-14 dnů=Cancel before 8-14 days 
Aktuální výběr osob převyšuje maximální kapacitu lůžek=Number of persons is wrong
Storno 3-7 dnů=Cancel before 3-7 days
Storno 0-2 dny=Cancel before 2-0 days
Storno podmínky=Storno podmínky
Dokončit rezervaci=Confirm reservation
Zrušit transfer=Cancel transfer
Objednat transfer=Reserve transfer
UPRAVIT HLEDÁNÍ=Change searching
Počet osob=Person
Stravování=Meal
Odjezd=Check out
Příjezd=Check in
Vyhledat pokoj=Search
Odeslat=Submit
Adresa:=Address:
E-mail:=E-mail:
Tel:=Tel:     
Zaplatit bankovním převodem=Bank transfer
Zaplatit kartou online=Pay online
Ne=No
Ano=Yes
Order=Order
Moje rezervace=My reservation
Platba byla zrušena=Payment was canceled 
Vystavit fakturu - 138 €=Pay by bank - 138 €
Informace o platbě a fakturu obdržíte e-mailem.=Payment information and invoice you can find in your email.
Do =Before 
Kliknutím zobrazíte storno podmínky=Kliknutím zobrazíte storno podmínky
Rezervaci je možné zdarma stronovat do =Rezervaci je možné zdarma stronovat do 